; Name: PortMaster
; Description: PortMaster
; Author: PortMaster
; Date: 2025-06-11
; Difficulty: Normal

; PM
WWWWWWWWWWWWWWWWWWWW
W...............K..W
W.BBBB.BB...BB.....W
W.BM.B.B.BCB.B.K...W
W.B..B.B..B..B.K.K.W
W.BBBB.B..K..B...K.W
W.B....B.....B.....W
W.B....B.....B..K..W
W.B....B.....B.....W
W..................W
W..........K.......W
W..............K...W
W..................W
W..................W
WWWWWWWWWWWWWWWWWWWW
